11111111
10000001
10010011
110000N1
11111111

11111111
10000001
10000011
100N0001
11111111