11111111
10000001
10100001
110000N1
11111111