
NO ./texture/1.xpm


SO ./texture/2.xpm




WE ./texture/3.xpm

C 225,30,0


EA   ./texture/6.xpm

            


F 2     ,       22,     255         




    1
   101111111111
  10001       
 1000001  1
1010001  101
11 10001  1
1010N0001
111111111   1
